city_code,都道府県,市区町村,総人口,保育サービスの使いやすさ,コロナ後の昼間人口増加率,WiFiスポット数（一人あたり）,徒歩での日常サービスへのアクセス,通勤時間の短さ,地域内経済循環,new_value総合点,納税者一人あたり平均所得,失業率,小売店増加率（2007→2016年）,人口増加率（2010→2020）,old_value総合点
12220,千葉県,流山市,195476,9,10,1,10,10,10,50,6,5,8,10,29
23205,愛知県,半田市,120078,9,8,8,6,7,10,48,5,5,6,6,22
25202,滋賀県,彦根市,112975,10,8,9,6,9,5,47,3,6,7,7,23
12206,千葉県,木更津市,135617,7,9,9,5,6,10,46,4,4,10,8,26
29205,奈良県,橿原市,121736,6,7,8,9,5,10,45,4,2,7,3,16
47201,沖縄県,那覇市,322011,6,3,10,10,6,10,45,3,1,1,6,11
1203,北海道,小樽市,114425,9,4,9,8,9,4,43,1,1,5,1,8
1206,北海道,釧路市,168086,8,2,7,7,10,9,43,1,3,6,1,11
31201,鳥取県,鳥取市,186960,6,5,10,6,10,6,43,1,3,5,2,11
35215,山口県,周南市,142482,9,6,5,5,9,9,43,3,5,2,1,11
44202,大分県,別府市,116821,9,1,9,10,10,4,43,1,1,3,3,8
16202,富山県,高岡市,170493,4,8,9,5,8,8,42,2,6,2,2,12
20202,長野県,松本市,238737,7,5,10,4,9,7,42,4,6,7,5,22
24202,三重県,四日市市,311551,8,6,9,4,6,9,42,5,8,7,6,26
29209,奈良県,生駒市,119483,3,9,10,8,2,10,42,6,4,9,5,24
32203,島根県,出雲市,174995,9,6,7,2,9,9,42,1,10,10,10,31
33203,岡山県,津山市,100669,9,7,9,2,10,5,42,1,3,3,1,8
7203,福島県,郡山市,322996,8,7,10,4,8,4,41,3,2,5,3,13
12222,千葉県,我孫子市,132183,10,10,1,9,1,10,41,5,4,3,3,15
13104,東京都,新宿区,348452,7,1,10,9,4,10,41,10,6,7,10,33
15222,新潟県,上越市,191197,10,7,5,2,10,7,41,1,6,3,1,11
21214,岐阜県,可児市,102327,10,7,5,4,7,8,41,2,5,5,9,21
23100,愛知県,名古屋市,2301639,6,1,10,10,5,9,41,6,4,3,8,21
40100,福岡県,北九州市,950602,9,3,6,9,6,8,41,3,1,1,3,8
1202,北海道,函館市,255308,2,1,8,9,10,10,40,1,1,4,1,7
2201,青森県,青森市,281232,2,7,9,7,9,6,40,1,1,2,1,5
12100,千葉県,千葉市,972516,6,7,6,9,3,9,40,5,3,8,8,24
12212,千葉県,佐倉市,175045,10,8,2,8,4,8,40,5,4,7,5,21
13118,東京都,荒川区,217146,9,10,3,9,3,6,40,5,4,1,10,20
14213,神奈川県,大和市,239192,7,10,7,7,2,7,40,5,3,5,9,22
23219,愛知県,小牧市,153026,8,6,8,6,9,3,40,4,5,7,8,24
31202,鳥取県,米子市,147857,4,4,9,5,9,9,40,2,5,3,4,14
38205,愛媛県,新居浜市,118970,10,7,5,3,10,5,40,2,5,3,2,12
2202,青森県,弘前市,170212,2,2,10,6,9,10,39,1,3,4,1,9
7202,福島県,会津若松市,118322,2,2,10,7,10,8,39,1,1,5,1,8
7204,福島県,いわき市,321535,8,4,9,3,8,7,39,2,2,5,1,10
11225,埼玉県,入間市,147727,9,9,5,1,5,10,39,3,3,10,4,20
12204,千葉県,船橋市,642938,9,9,5,10,1,5,39,5,5,8,9,27
13103,東京都,港区,260379,2,10,10,9,5,3,39,10,10,1,10,31
13105,東京都,文京区,226114,8,1,9,9,4,8,39,10,10,1,10,31
21213,岐阜県,各務原市,147651,9,9,5,1,7,8,39,3,6,10,6,25
23207,愛知県,豊川市,186802,10,6,7,5,6,5,39,3,6,10,7,26
23217,愛知県,江南市,100615,10,8,2,4,5,10,39,4,5,6,5,20
23220,愛知県,稲沢市,136702,10,8,4,4,4,9,39,4,8,9,6,27
24204,三重県,松阪市,163477,10,5,6,3,6,9,39,3,4,3,3,13
34212,広島県,東広島市,188779,9,6,5,4,7,8,39,3,8,7,8,26
37201,香川県,高松市,427131,5,3,9,6,8,8,39,3,4,6,5,18
40219,福岡県,大野城市,101156,7,8,5,10,5,4,39,4,3,7,8,22
41202,佐賀県,唐津市,121278,4,8,4,4,9,10,39,1,2,3,1,7
43202,熊本県,八代市,126667,10,3,6,8,10,2,39,1,2,1,2,6
1207,北海道,帯広市,166043,6,2,8,7,10,5,38,2,5,10,4,21
4215,宮城県,大崎市,129444,10,7,8,1,8,4,38,1,2,5,2,10
9201,栃木県,宇都宮市,521754,5,6,9,2,6,10,38,5,4,8,7,24
11218,埼玉県,深谷市,143219,9,7,5,1,6,10,38,2,2,7,4,15
12207,千葉県,松戸市,498473,7,9,4,10,1,7,38,5,3,6,8,22
12224,千葉県,鎌ケ谷市,109954,8,9,2,10,1,8,38,4,2,6,7,19
13102,東京都,中央区,168361,5,1,10,9,5,8,38,10,10,8,10,38
13113,東京都,渋谷区,229671,5,1,10,9,4,9,38,10,5,8,10,33
13116,東京都,豊島区,290246,8,1,10,9,3,7,38,8,3,9,10,30
14206,神奈川県,小田原市,190580,9,4,9,2,5,9,38,4,4,2,3,13
22210,静岡県,富士市,253354,5,5,7,6,8,7,38,3,4,9,4,20
24207,三重県,鈴鹿市,199884,10,7,7,2,7,5,38,4,5,10,7,26
27210,大阪府,枚方市,401074,8,9,1,9,3,8,38,4,2,3,4,13
33100,岡山県,岡山市,708973,4,2,9,7,7,9,38,4,3,8,7,22
38206,愛媛県,西条市,108961,8,10,6,3,10,1,38,1,3,4,2,10
40203,福岡県,久留米市,305311,9,3,3,7,7,9,38,3,2,4,5,14
41201,佐賀県,佐賀市,232476,1,4,10,5,8,10,38,3,4,9,4,20
42202,長崎県,佐世保市,249681,4,6,5,6,8,9,38,2,1,6,2,11
2203,青森県,八戸市,227812,1,3,10,4,10,9,37,1,1,5,2,9
8201,茨城県,水戸市,271912,6,2,10,7,6,6,37,5,4,8,6,23
13109,東京都,品川区,401704,8,1,9,9,4,6,37,10,6,4,10,30
13117,東京都,北区,353908,9,9,4,9,3,3,37,5,4,1,10,20
13205,東京都,青梅市,133032,10,8,2,2,5,10,37,3,2,1,2,8
13214,東京都,国分寺市,125170,9,10,4,8,1,5,37,8,6,3,9,26
20201,長野県,長野市,375884,8,2,8,6,8,5,37,3,6,7,3,19
22203,静岡県,沼津市,194869,7,5,9,7,8,1,37,3,2,4,1,10
23222,愛知県,東海市,115058,10,4,8,6,6,3,37,5,10,4,9,28
24203,三重県,伊勢市,125462,3,1,10,4,9,10,37,3,5,4,2,14
34100,広島県,広島市,1195775,7,3,7,10,6,4,37,5,4,9,7,25
37202,香川県,丸亀市,112899,6,8,6,2,7,8,37,2,4,8,6,20
40202,福岡県,大牟田市,113587,8,7,4,5,10,3,37,1,1,3,1,6
47208,沖縄県,浦添市,115340,4,5,6,9,6,7,37,1,1,1,7,10
47211,沖縄県,沖縄市,142634,5,6,6,6,7,7,37,1,1,1,8,11
8221,茨城県,ひたちなか市,158660,10,4,7,3,6,6,36,4,4,9,5,22
13107,東京都,墨田区,274896,4,2,10,9,4,7,36,6,5,3,10,24
13112,東京都,世田谷区,917486,6,9,3,9,2,7,36,10,6,3,10,29
13114,東京都,中野区,335234,3,9,3,9,3,9,36,6,3,2,10,21
13119,東京都,板橋区,571357,5,10,2,9,2,8,36,5,3,1,10,19
13208,東京都,調布市,237054,8,10,4,8,1,5,36,6,2,3,9,20
14100,神奈川県,横浜市,3754772,8,8,4,8,1,7,36,6,5,6,7,24
14203,神奈川県,平塚市,256947,9,4,5,3,5,10,36,4,4,5,5,18
20205,長野県,飯田市,100702,7,7,6,5,10,1,36,1,10,7,2,20
27223,大阪府,門真市,121575,1,9,7,9,4,6,36,2,1,1,2,6
32201,島根県,松江市,201981,8,5,8,5,9,1,36,2,10,9,8,29
33202,岡山県,倉敷市,482250,8,5,5,3,6,9,36,2,5,5,6,18
35206,山口県,防府市,115888,8,5,4,1,10,8,36,2,3,4,4,13
46201,鹿児島県,鹿児島市,602465,4,3,9,7,7,6,36,2,2,6,5,15
5201,秋田県,秋田市,307403,3,3,10,3,9,7,35,2,3,5,2,12
13108,東京都,江東区,521835,5,1,9,9,3,8,35,8,5,5,10,28
13121,東京都,足立区,691298,5,10,3,9,2,6,35,4,3,1,9,17
13122,東京都,葛飾区,464550,8,10,5,9,2,1,35,5,4,2,9,20
13123,東京都,江戸川区,700079,5,10,2,9,2,7,35,5,4,2,9,20
17201,石川県,金沢市,452220,2,2,10,9,9,3,35,4,6,6,6,22
17203,石川県,小松市,108265,1,8,8,2,9,7,35,2,8,8,5,23
23202,愛知県,岡崎市,387791,10,6,4,6,5,4,35,5,8,8,8,29
23206,愛知県,春日井市,311338,8,6,3,6,4,8,35,5,5,6,7,23
27100,大阪府,大阪市,2730420,5,1,10,10,5,4,35,4,1,1,9,15
30201,和歌山県,和歌山市,366923,2,4,8,7,8,6,35,4,2,6,3,15
34207,広島県,福山市,468956,3,5,3,6,8,10,35,2,4,6,6,18
35208,山口県,岩国市,133626,7,5,2,2,9,10,35,2,5,2,1,10
39201,高知県,高知市,327575,7,3,7,3,8,7,35,2,2,6,2,12
40130,福岡県,福岡市,1554229,8,1,9,10,5,2,35,5,2,4,10,21
40205,福岡県,飯塚市,128184,6,5,7,3,9,5,35,1,1,1,3,6
43100,熊本県,熊本市,733721,2,4,8,10,7,4,35,3,3,5,6,17
1204,北海道,旭川市,334070,5,2,8,7,10,2,34,1,2,9,2,14
1213,北海道,苫小牧市,171242,4,2,5,7,9,7,34,1,3,7,4,15
6203,山形県,鶴岡市,125500,9,2,9,2,10,2,34,1,5,5,1,12
8203,茨城県,土浦市,142030,4,6,9,4,8,3,34,3,2,7,4,16
10204,群馬県,伊勢崎市,213366,4,5,6,3,7,9,34,2,3,9,9,23
11224,埼玉県,戸田市,140642,6,10,6,8,2,2,34,5,4,8,10,27
12208,千葉県,野田市,154373,9,7,3,5,4,6,34,2,4,7,5,18
14130,神奈川県,川崎市,1514299,7,10,3,10,2,2,34,6,5,4,10,25
21201,岐阜県,岐阜市,408804,4,5,6,3,6,10,34,5,5,3,5,18
21204,岐阜県,多治見市,110308,9,8,1,4,6,6,34,3,6,4,2,15
22100,静岡県,静岡市,698275,1,3,8,8,7,7,34,4,3,5,3,15
22130,静岡県,浜松市,802527,1,6,6,7,7,7,34,4,4,8,6,22
23203,愛知県,一宮市,385228,10,8,3,5,4,4,34,4,5,7,6,22
23212,愛知県,安城市,190228,10,5,4,6,5,4,34,6,10,9,9,34
27220,大阪府,箕面市,138377,6,9,3,6,3,7,34,8,4,9,9,30
27227,大阪府,東大阪市,488618,1,4,6,9,5,9,34,3,1,1,5,10
34213,広島県,廿日市市,117252,10,2,3,7,4,8,34,3,6,10,5,24
38202,愛媛県,今治市,158386,4,6,7,3,10,4,34,2,1,3,1,7
4202,宮城県,石巻市,142638,7,3,9,2,8,4,33,2,1,1,1,5
8220,茨城県,つくば市,237653,8,6,8,3,7,1,33,6,8,10,10,34
11100,埼玉県,さいたま市,1314145,5,9,5,5,2,7,33,6,4,9,9,28
11202,埼玉県,熊谷市,196829,7,5,6,1,5,9,33,3,2,5,3,13
11203,埼玉県,川口市,607105,5,10,1,5,2,10,33,5,3,8,10,26
12216,千葉県,習志野市,173885,2,5,5,10,1,10,33,6,3,9,9,27
12217,千葉県,柏市,424920,7,9,5,9,1,2,33,5,4,9,9,27
12221,千葉県,八千代市,199786,4,10,4,10,2,3,33,5,5,8,8,26
13202,東京都,立川市,184090,7,4,9,4,2,7,33,6,3,9,8,26
13203,東京都,武蔵野市,146871,3,1,10,8,1,10,33,10,6,7,9,32
14150,神奈川県,相模原市,718300,6,9,4,3,3,8,33,4,3,4,7,18
20203,長野県,上田市,156810,10,4,7,3,8,1,33,2,5,6,4,17
22206,静岡県,三島市,109445,9,1,7,7,6,3,33,5,4,2,3,14
22211,静岡県,磐田市,169818,5,5,6,3,8,6,33,2,5,10,6,23
22212,静岡県,焼津市,139435,7,6,6,4,9,1,33,2,5,9,3,19
23201,愛知県,豊橋市,377429,4,7,5,6,6,5,33,4,6,6,7,23
25206,滋賀県,草津市,134926,7,2,9,8,5,2,33,5,6,10,10,31
27140,大阪府,堺市,834787,10,7,3,9,3,1,33,4,1,2,5,12
28202,兵庫県,尼崎市,463262,5,8,4,10,4,2,33,3,1,1,5,10
28203,兵庫県,明石市,303961,5,8,2,10,3,5,33,4,2,2,7,15
35202,山口県,宇部市,164255,10,5,5,2,9,2,33,3,2,6,2,13
36201,徳島県,徳島市,253054,4,3,8,7,8,3,33,4,3,4,3,14
40218,福岡県,春日市,113316,9,7,1,10,4,2,33,4,2,6,7,19
44201,大分県,大分市,478393,2,4,6,7,8,6,33,3,3,7,6,19
47213,沖縄県,うるま市,124457,7,3,7,4,7,5,33,1,1,1,8,11
1100,北海道,札幌市,1959313,4,3,7,9,5,4,32,3,1,9,7,20
3201,岩手県,盛岡市,288470,3,1,10,7,9,2,32,3,3,9,4,19
4100,宮城県,仙台市,1064060,6,2,10,4,5,5,32,5,2,9,8,24
11217,埼玉県,鴻巣市,118395,4,10,1,6,3,8,32,3,3,9,5,20
11245,埼玉県,ふじみ野市,114306,7,10,3,1,1,10,32,5,4,6,9,24
13115,東京都,杉並区,574118,4,10,2,9,2,5,32,10,5,1,9,25
13206,東京都,府中市,260232,7,9,4,7,2,3,32,6,5,4,8,23
13209,東京都,町田市,428821,6,8,3,5,1,9,32,6,4,8,7,25
13211,東京都,小平市,194869,7,8,1,7,1,8,32,6,4,5,9,24
13222,東京都,東久留米市,116916,6,10,1,6,1,8,32,5,3,10,6,24
14215,神奈川県,海老名市,134442,9,4,8,2,3,6,32,5,5,10,8,28
15100,新潟県,新潟市,788465,7,3,7,1,8,6,32,2,4,5,3,14
22213,静岡県,掛川市,117804,2,4,8,3,7,8,32,3,4,7,6,20
24205,三重県,桑名市,142019,10,3,8,2,5,4,32,5,8,10,7,30
26100,京都府,京都市,1409702,6,1,8,10,5,2,32,5,3,1,6,15
27202,大阪府,岸和田市,194162,1,8,2,7,5,9,32,2,1,1,3,7
27214,大阪府,富田林市,111033,10,9,1,6,3,3,32,4,2,2,1,9
28201,兵庫県,姫路市,535982,1,6,6,7,7,5,32,4,3,2,5,14
28207,兵庫県,伊丹市,203539,6,8,3,10,4,1,32,4,2,2,7,15
28210,兵庫県,加古川市,264364,2,8,4,6,5,7,32,3,3,2,4,12
40230,福岡県,糸島市,101866,10,8,1,6,4,3,32,2,2,5,6,15
6201,山形県,山形市,244998,4,5,10,2,9,1,31,3,5,4,3,15
6204,山形県,酒田市,101331,3,5,9,3,10,1,31,1,4,4,1,10
7201,福島県,福島市,277133,3,5,9,4,8,2,31,3,5,8,2,18
9204,栃木県,佐野市,117968,3,1,8,2,9,8,31,2,2,4,2,10
9213,栃木県,那須塩原市,117458,3,5,10,1,10,2,31,2,5,10,5,22
13106,東京都,台東区,202431,3,1,10,9,4,4,31,6,5,4,10,25
13110,東京都,目黒区,281474,3,4,7,9,3,5,31,10,8,4,10,32
13207,東京都,昭島市,113397,9,7,4,4,3,4,31,4,2,4,6,16
14205,神奈川県,藤沢市,436206,7,7,4,5,2,6,31,6,5,7,9,27
15202,新潟県,長岡市,268872,8,3,6,3,9,2,31,1,5,5,2,13
18201,福井県,福井市,263152,1,2,8,6,8,6,31,3,6,8,4,21
21202,岐阜県,大垣市,161310,6,6,6,1,7,5,31,4,4,7,6,21
22207,静岡県,富士宮市,132299,4,4,9,4,8,2,31,2,5,9,4,20
22214,静岡県,藤枝市,144662,3,5,5,3,6,9,31,3,6,10,6,25
23204,愛知県,瀬戸市,129527,10,3,3,7,5,3,31,4,6,6,5,21
23213,愛知県,西尾市,172350,10,7,2,3,7,2,31,5,6,10,10,31
27205,大阪府,吹田市,373557,2,5,2,10,3,9,31,6,4,5,9,24
27213,大阪府,泉佐野市,100420,1,1,8,5,6,10,31,3,1,8,4,16
34205,広島県,尾道市,136156,3,6,2,5,10,5,31,2,4,3,1,10
35203,山口県,山口市,191529,8,4,9,1,8,1,31,2,6,6,4,18
38201,愛媛県,松山市,511310,3,2,7,8,8,3,31,2,2,4,4,12
42201,長崎県,長崎市,416405,3,3,7,8,6,4,31,2,3,4,1,10
45201,宮崎県,宮崎市,402632,2,2,7,7,9,4,31,2,2,7,5,16
1208,北海道,北見市,116630,1,1,8,4,10,6,30,1,4,8,1,14
11219,埼玉県,上尾市,228779,5,9,3,8,2,3,30,4,4,9,6,23
12203,千葉県,市川市,490192,6,10,2,10,1,1,30,6,5,2,8,21
12211,千葉県,成田市,132735,9,1,10,5,4,1,30,4,6,9,8,27
13204,東京都,三鷹市,188461,6,9,1,7,1,6,30,8,6,4,8,26
13210,東京都,小金井市,122306,4,8,2,6,1,9,30,6,5,3,9,23
16201,富山県,富山市,415765,1,3,8,5,8,5,30,3,8,2,5,18
26204,京都府,宇治市,185878,2,9,1,10,5,3,30,4,3,1,3,11
27203,大阪府,豊中市,408464,1,10,1,10,3,5,30,8,3,2,8,21
27217,大阪府,松原市,119577,8,2,1,7,4,8,30,2,1,1,2,6
27222,大阪府,羽曳野市,111042,8,4,1,5,4,8,30,3,1,2,2,8
28219,兵庫県,三田市,111934,2,7,5,6,2,8,30,5,6,8,4,23
42204,長崎県,諫早市,136679,5,7,4,5,7,2,30,1,2,8,2,13
45202,宮崎県,都城市,164506,1,4,8,2,10,5,30,1,2,4,2,9
8204,茨城県,古河市,142992,1,7,4,2,8,7,29,2,1,5,4,12
8217,茨城県,取手市,107097,3,9,1,8,2,6,29,3,2,3,3,11
11210,埼玉県,加須市,113043,9,9,2,1,6,2,29,2,4,10,3,19
12219,千葉県,市原市,275385,4,8,5,4,5,3,29,3,4,9,4,20
13120,東京都,練馬区,739435,7,10,1,9,1,1,29,6,5,3,8,22
14201,神奈川県,横須賀市,401050,3,8,2,2,4,10,29,4,2,2,2,10
23210,愛知県,刈谷市,152665,9,2,7,4,6,1,29,6,10,7,9,32
28204,兵庫県,西宮市,484357,3,4,3,10,2,7,29,8,4,4,7,23
40217,福岡県,筑紫野市,104038,8,3,3,8,3,4,29,3,2,10,7,22
46203,鹿児島県,鹿屋市,102875,2,6,6,1,10,4,29,1,1,6,3,11
46218,鹿児島県,霧島市,125469,1,1,7,2,10,8,29,1,2,7,3,13
8227,茨城県,筑西市,104059,2,7,5,2,6,6,28,1,1,7,2,11
11214,埼玉県,春日部市,234137,8,8,2,1,3,6,28,3,2,10,4,19
13111,東京都,大田区,734493,5,6,4,9,3,1,28,8,5,4,9,26
13212,東京都,日野市,186346,7,6,1,5,2,7,28,5,5,6,9,25
14204,神奈川県,鎌倉市,176408,5,7,4,2,1,9,28,8,5,9,5,27
19201,山梨県,甲府市,187880,2,1,10,5,9,1,28,4,2,4,3,13
23211,愛知県,豊田市,425145,7,1,6,3,6,5,28,6,10,9,7,32
24201,三重県,津市,278105,6,4,7,3,7,1,28,4,6,5,4,19
27209,大阪府,守口市,143884,1,4,3,10,4,6,28,4,1,1,4,10
27211,大阪府,茨木市,282362,1,3,2,9,3,10,28,5,2,5,8,20
27212,大阪府,八尾市,266349,1,6,3,8,4,6,28,4,1,1,5,11
27215,大阪府,寝屋川市,231700,4,6,2,9,3,4,28,3,1,2,3,9
10205,群馬県,太田市,224415,2,2,8,1,9,5,27,3,3,6,8,20
11215,埼玉県,狭山市,150719,8,6,2,3,5,3,27,3,2,4,3,12
11230,埼玉県,新座市,165727,5,9,1,2,1,9,27,5,4,8,8,25
11232,埼玉県,久喜市,153066,2,7,4,1,4,9,27,3,3,10,4,20
13213,東京都,東村山市,151255,6,10,1,3,1,6,27,5,4,2,5,16
17210,石川県,白山市,113715,3,3,6,4,8,3,27,2,6,6,5,19
25203,滋賀県,長浜市,117892,1,6,5,3,9,3,27,2,6,10,3,21
28214,兵庫県,宝塚市,234044,4,9,1,9,3,1,27,6,3,3,7,19
45203,宮崎県,延岡市,122166,1,7,3,4,10,2,27,1,1,8,1,11
1217,北海道,江別市,119580,2,6,2,6,6,4,26,1,2,9,3,15
3215,岩手県,奥州市,116082,2,3,7,2,10,2,26,1,5,6,1,13
8202,茨城県,日立市,177769,2,3,4,6,6,5,26,4,1,2,1,8
9202,栃木県,足利市,147442,5,5,3,1,8,4,26,2,2,2,2,8
9208,栃木県,小山市,167505,6,2,8,1,7,2,26,3,3,7,8,21
12227,千葉県,浦安市,170169,4,1,7,10,2,2,26,8,8,7,8,31
12231,千葉県,印西市,103513,4,9,5,5,1,2,26,6,6,10,10,32
13201,東京都,八王子市,562480,10,2,4,3,2,5,26,5,3,7,6,21
13229,東京都,西東京市,205125,6,10,2,6,1,1,26,6,4,2,9,21
14207,神奈川県,茅ヶ崎市,243884,7,8,1,2,1,7,26,6,5,3,7,21
14216,神奈川県,座間市,131698,6,10,2,2,3,3,26,4,3,8,7,22
25201,滋賀県,大津市,343815,5,2,3,8,4,4,26,5,5,3,7,20
35201,山口県,下関市,260897,3,3,4,6,8,2,26,2,3,3,1,9
10202,群馬県,高崎市,373114,2,4,6,5,7,1,25,4,3,7,5,19
11201,埼玉県,川越市,353301,6,5,3,1,3,7,25,4,4,9,8,25
11208,埼玉県,所沢市,344233,5,8,2,1,1,8,25,5,4,8,6,23
11222,埼玉県,越谷市,344528,3,10,7,1,1,3,25,4,4,10,9,27
11239,埼玉県,坂戸市,101026,5,2,3,4,5,6,25,3,1,5,6,15
14214,神奈川県,伊勢原市,100427,3,3,7,1,5,6,25,5,5,3,7,20
27219,大阪府,和泉市,186079,1,4,2,5,4,9,25,4,2,10,6,22
28217,兵庫県,川西市,157432,3,9,1,8,3,1,25,5,1,2,4,12
3209,岩手県,一関市,115426,2,2,6,2,10,2,24,1,4,7,2,14
9203,栃木県,栃木市,159951,1,8,6,1,7,1,24,2,3,10,10,25
10203,群馬県,桐生市,110122,3,4,1,3,9,4,24,2,3,2,1,8
25213,滋賀県,東近江市,114316,1,7,4,2,7,3,24,2,6,6,5,19
28100,兵庫県,神戸市,1533588,1,1,6,10,3,3,24,5,2,1,6,14
34202,広島県,呉市,221502,4,3,2,7,5,3,24,2,5,2,1,10
10201,群馬県,前橋市,336115,1,4,5,4,7,2,23,4,5,6,4,19
11221,埼玉県,草加市,249645,5,9,3,1,2,3,23,4,3,5,8,20
11235,埼玉県,富士見市,111620,3,10,4,1,1,4,23,5,4,10,8,27
14212,神奈川県,厚木市,224378,6,1,8,1,6,1,23,5,3,8,7,23
27204,大阪府,池田市,103613,3,5,1,5,3,6,23,6,3,1,6,16
27216,大阪府,河内長野市,104562,5,5,1,5,2,5,23,3,2,1,1,7
11237,埼玉県,三郷市,142529,3,9,5,1,2,2,22,4,3,10,9,26
14211,神奈川県,秦野市,161193,2,4,6,1,4,5,22,3,2,3,5,13
27218,大阪府,大東市,120285,2,2,2,8,4,3,21,2,1,2,2,7
29201,奈良県,奈良市,356027,2,6,5,4,3,1,21,6,3,3,3,15
11227,埼玉県,朝霞市,141802,5,10,2,1,1,1,20,5,5,5,10,25
13224,東京都,多摩市,148823,6,1,3,4,2,4,20,5,2,9,7,23
27207,大阪府,高槻市,351503,1,6,1,5,2,3,18,5,2,5,4,16